1111111111
1E00000001
1010010101
1010010011
1P000000C1
1011111111
1011111111
1011111111
10000000C1
1111111111
