1111111111
1000000001
1000000001
100000X001
1000000001
1000000001
1000000001
1000000001
1000000001
1000000001
1000111101
1000000001
1000X00001
10000P0001
1000000001
1000E00001
1000000001
1000000001
1000000C01
1111111111
